NO     ./textures/wall.xpm
SO    ./textures/wall2.xpm
WE ./textures/wall4.xpm
EA ./textures/wall2.xpm

F 22,22,22

C 60,0,0



11111111111111111111111111111
10000000001100000111011111111
11110111111111011100000010101
11110111111111011101010011101
11000000110101011100000010001
10000000100100000100000010011
100000000000W0001101010010001
11000001110101011111011110011
11110111111101011101111010001
11111111111111111111111111111
11111111111111111111111111111
