NO ./textures/icardi.xpm
SO ./textures/icardi2.xpm
EA ./textures/icardi3.xpm
WE ./textures/icardi4.xpm

C 253,185,18

F 169,4,50


11111111111111111
10000000000000001
10100000100000101
10000000000000001
10001000100010001
10000000000000001
10101010N01010101
10000000000000001
10001000100100001
10000000000000001
10100000100001001111111
10000000000000001
 0              1  
11111011111111111
    101
11111011111111111
10000000000000001
10100000100000101
10000000000000001
10001000100010001
10000000000000001
10101010001010101
10000000000000001
10001000100100001
10000000000000001
10100000100001001
10000000000000001
11111111111111111