NO ./textures/barrel.xpm
SO ./textures/barrel.xpm
EA ./textures/barrel.xpm
WE ./textures/barrel.xpm

C 207,2,149
F 247,239,129


11111111111111111
11111100000000001
10100000100000101
10000000000000001
10001000100010001
10000000000000001
1010101N001010101
10000000000000001
10001000100100001
10000000000000001
10100000100001001
10000000000000001
11111111111111111
