NO ./textures/barrel.xpm
SO ./textures/barrel.xpm
EA ./textures/barrel.xpm
WE ./textures/barrel.xpm

C 207,231,149
F 247,239,129

11111111111111111
10000000000000001
10100000100000101
10000000000000001
10001000100010001
10000000000000001
10101010N01010101
10000000000000001
1000100010011111
100000000010
1010000010001111
10000000000000001
11111111111111111
