










                                            

















NOA ./textures/eagle.xpm
SO ./textures/eagle.xpm
EA ./textures/eagle.xpm
WE ./textures/eagle.xpm

C 9,4,70
F 247,23,53

11111111111111111
10000000000000001
10100000100000101
10000000000000001
10001000100010001111111111111111111111
10000000000000000000000000000000000001
10101010N01010101111111111111111111111
10000000000000001
10001000100100001
10000000000000001
10100000100001001
10000000000000001
11111111111111111
