
NO ./textures/purplestone.xpm
EA ./textures/purplestone.xpm
WE ./textures/purplestone.xpm


C 98,76,171
SO ./textures/bluestone.xpm
F 193,206,254

11111111111111111                      11111111111111111
10000000000000001                      10000000000000001
10100000100000101                      10000000000000001
10000000000000001                      10000000000000001
10001000100010001111111111111111111111110000000AAA000001
10000000000000000000000000000000000000000000000000000001
10101010N01010101111111111111111111111111111111111111111
10000000000000001
10001000100100001
10000000000000001
10100000100001001
10000000000000001
11111111111111111
